###########
###########
##.#####.##
#.##.##.#.#
##.......##
#.#######.#
#.#.###.#.#
#.#######.#
#.###@###.#
##.......##
###########